   ###########################
## ##################   ######
## #                  #   ####
## # ### ######## #########* #
#    #         #              
##############################
