   ##########################
#  #         #              #
#  #  ###### #    ######### #
#  #  #####  ####  ######## #
#     #####              #* #
#############################