#############################
#  #         ####     #     #
#  #         #    #   # ### #
#  ###########  ###       # #
#                 #  ##   #*#
#############################