#############################
#               #############
#####  #######  #           #
#   #    #   #  # ########  #
#    ##      #    #         *
#############################