   ##########################
#               #############
#####  #######  #           #
#   #    #   #  # ########  #
#    ##      #    #         *
#############################