   ##########################
#          #*               #
## ###### # ############### #
##      # # #       ###   # #
##     #          #     #   #
#############################
