##############################
#  ##################   ######
## #                  #   ####
## # ### ######## #########* #
#    #         #             #
##############################
