   ###########################
## ##################   ######
## #                  #   ####
## # ### ######## #########* #
#    #         #             #
##############################
